####################
#S                ##
############ ##    #
#            #######
# ##   #####       #
#     #####  ##    #
#### ######  ##### #
#### ######    #   #
#     ###    ##### #
#   ####     ###   #
###              ###
### ###### #########
#####              #
##    #### ## #### #
## ####### ## # ####
#       ## ## #    #
# #####  #      ####
# # ######## #######
#                 F#
####################